111111111111111111111111
1CCCCCCCCCCCCCCCCCCCCCC1
1C11111111111111111111C1
1C1PP000000C0000000001C1
1C10000000000000000000C1
1C1E0000000C0000000001C1
1C11111111111111111111C1
1CCCCCCCCCCCCCCCCCCCCCC1
111111111111111111111111