111111111111111111111
100C000CC0000000C0001
100000000000000000001
100011100010010100C01
10001C100010011100001
100000100000000CCC001
1111111100C0011111111
100000CCCC00000000001
10010010000001000C001
1P0100100C001000100E1
111111111111111111111