111111111111111111111
1000P0000000000000001
100000000000000000001
100111000C01010000001
1001C1000001110000001
100000000000000000001
1111111100C0011111111
100000000000000000001
100100100000100001001
100100100C001000010E1
111111111111111111111