11111111111111111111111111111111111
1P0000000000010000000000000M0000001
111111111111010MM0011110000M0C00001
1000000000C1010MM0000000000M0000001
100111111111010MMMMM000000000000001
100000000000010MM0CM0M0000001111111
101111111110110MM0CC0M00000000000E1
100000000000000MM0CM0M0000001111111
110011111101010MMMMM000000000000001
100000000101010MM000MM00000M0000001
111111111101010MM000MC00000M0C00001
1C00C0000001010000011110000M0000001
11111111111111111111111111111111111