11111111111111111111111111111111111
1P000000000001000000000000000100001
11111111111101000001111000001C10001
1000000000C101000000000000000100001
10011111111101000000000000000000001
100000000000010000C0000000001111111
101111111110110000CC0000000000000E1
1000000000000000000C000000001111111
11001111110101000000000000000000001
10000000010101000000000000000000001
11111111110101000000C00000000C00001
1C00C000000101000001111000000000001
11111111111111111111111111111111111