111111111111111111111111
1CCCCCCCCCCCCCCCCCCCCCC1
1C11111111111111111111C1
1C1P0000M00C0000000001C1
1C1000000000000MC0000MC1
1C10EE00000C0000000001C1
1C11110111111111111111C1
1CCCCCCCCCCCCCCCCCCCCCC1
111111111111111111111111