1111111111111111111111111111111111
101000000000000M010000000000000001
11P1000000000000010000000000000001
1010000000C00000010000000000000001
1000000000000000010000000000000001
1000000000000000010000000000000001
1000M000000000M0010000000000000001
1000000000C00000010000000000000001
1000000000000000010000000000000001
1000000000000000010000000000000001
11E1000000000100010000000000000001
1111111111111111111111111111111111